1111111111
1000C10001
1000000001
1000000001
1C1110P0E1
1111111111