1111111111111
10001111C0001
100000E000001
1P00000000001
1111111111111