111111
1C1111
1000P1
1E0001
111111