1111111111111111
1000000000000011
10000000000C0E01
1P00000000000001
1111111111111111
